TTTTTTTTTTTPPPTTTTTTTTTT
TGGGGGGGGGGGPGGGGGGGGGGT
TGGGGGH GGGGPGGGGS GC GT
TGGGGG  GGGGPGGGG  G  GT
TGGPPPPPPPPPPPPPPPPPPPGT
TGGPGGGGGGGGGGGGGGGGGGGT
TGGPGGGGGGGGGGGL  GGGGGT
TGGPGGGGGGGGGGG   GGGGGT
TGGGGGGGGGGGGGG   GGGGGT
TGGGGGGGGGGGGGGGGGGGGGGT
TGGGGGGGGGGGGGGGGGGGGGGT
TTTTTTTTTTTTTTTTTTTTTTTT

